NO textures/wolfenstein/grey_stone.xpm
SO textures/wolfenstein/purple_stone.xpm
WE textures/wolfenstein/red_brick.xpm
EA textures/wolfenstein/wood.xpm

F	68, 68,  68
C	51, 104, 155

11111111111111111   11111
10000000000000011   11001
10000000000000001   10001
1000000000000000111110001
1000000000000000000000001
1100000000000000000000001
1000000000000000000000001
1000000000000000000000001
1000000000000000000000001
1000000000000000000000001
1100000000000000000000001
1000000000000000000000001
1000000000000000000000001
1000000000000000000000001
1000000000000000000000001
1000000000000000N00000001
1000000000000000000000001
1100000000000000000000001
1000000000000000000000001
11111000000000000000000011111
    1000000000000000000000011
11111000000000000000000011111
1100000000000000000000001
1100000000000000010000001
1111111111111111111111111

