NO textures/wolfenstein/grey_stone.xpm
SO textures/wolfenstein/purple_stone.xpm
WE textures/wolfenstein/red_brick.xpm
EA textures/wolfenstein/wood.xpm

F	68, 68,  68
C	51, 104, 155

111111111111111111111
10000000001111000000111
1000000000100000N000001
10000000001000000000001
11111111111111111111111
